game_id,team_id,team_name,num_players,opp_team_id,opp_team_name,opp_num_players,outcome,opp_pts,pts,fgm,fga,fgperc,twoptm,twopta,twoptperc,threeptm,threepta,threeptperc,ftm,fta,ftperc,oreb,dreb,reb,ast,tov,stl,blk,blka,fc,sfc,nsfc,fd,sfd,nsfd,pir
20191017-1930-burritos-northlondonlions,burritos,Burritos,7,northlondonlions,North L Lions,6,w,29,50,22,44,50.0,21,39,53.8,1,5,20.0,5,10,50.0,9,27,36,14,7,5,3,0,4,2,2,0,0,0,70
20191017-1930-burritos-northlondonlions,northlondonlions,North L Lions,6,burritos,Burritos,7,d,50,29,12,47,25.5,9,35,25.7,3,12,25.0,2,4,50.0,7,11,18,9,8,7,0,0,8,7,1,0,0,0,10
20191017-2015-camdenhells-lostangels,camdenhells,Camden Hells,7,lostangels,Lost Angels,5,d,56,34,15,54,27.8,14,36,38.9,1,18,5.6,3,4,75.0,5,20,25,8,6,5,4,0,3,1,2,0,0,0,27
20191017-2015-camdenhells-lostangels,lostangels,Lost Angels,5,camdenhells,Camden Hells,7,w,34,56,23,56,41.1,16,30,53.3,7,26,26.9,3,3,100.0,9,28,37,17,8,2,3,0,5,2,3,0,0,0,69
20191017-2100-greenmachine-lions,greenmachine,Green Machine,7,lions,Lions,6,d,39,34,13,44,29.5,11,31,35.5,2,13,15.4,6,15,40.0,13,18,31,4,9,6,1,0,6,4,2,0,0,0,21
20191017-2100-greenmachine-lions,lions,Lions,6,greenmachine,Green Machine,7,w,34,39,15,49,30.6,12,37,32.4,3,12,25.0,6,9,66.7,17,16,33,8,10,4,0,0,7,4,3,0,0,0,30
20191024-1845-lions-lostangels,lions,Lions,7,lostangels,Lost Angels,5,d,61,33,14,62,22.6,10,40,25.0,4,22,18.2,1,6,16.7,10,21,31,8,10,9,0,2,6,3,3,4,3,1,14
20191024-1845-lions-lostangels,lostangels,Lost Angels,5,lions,Lions,7,w,33,61,29,59,49.2,29,52,55.8,0,7,0,3,5,60.0,9,41,50,17,14,6,2,0,4,3,1,6,3,3,92
20191024-1930-greenmachine-northlondonlions,greenmachine,Green Machine,8,northlondonlions,North L Lions,7,d,57,42,17,46,37.0,15,36,41.7,2,10,20.0,6,10,60.0,9,25,34,15,16,4,0,1,8,3,5,11,5,6,48
20191024-1930-greenmachine-northlondonlions,northlondonlions,North L Lions,7,greenmachine,Green Machine,8,w,42,57,24,61,39.3,18,34,52.9,6,27,22.2,3,5,60.0,13,20,33,13,9,10,1,0,11,5,6,8,3,5,63
20191024-2015-camdenhells-rockets,camdenhells,Camden Hells,7,rockets,Rockets,8,d,49,29,11,31,35.5,10,24,41.7,1,7,14.3,6,15,40.0,4,19,23,7,20,5,1,0,14,8,6,16,7,9,18
20191024-2015-camdenhells-rockets,rockets,Rockets,8,camdenhells,Camden Hells,7,w,29,49,19,45,42.2,15,37,40.5,4,8,50.0,7,14,50.0,11,19,30,11,13,16,0,1,16,7,9,14,8,6,57
20191031-1845-hotshots-camdenhells,hotshots,Hot Shots,8,camdenhells,Camden Hells,9,d,58,37,14,41,34.1,11,31,35.5,3,10,30.0,6,12,50.0,5,21,26,9,12,2,4,5,14,11,3,9,6,3,23
20191031-1845-hotshots-camdenhells,camdenhells,Camden Hells,9,hotshots,Hot Shots,8,w,37,58,24,63,38.1,24,58,41.4,0,5,0,10,19,52.6,23,23,46,21,4,7,5,4,9,6,3,14,11,3,86
20191031-1930-greenmachine-burritos,greenmachine,Green Machine,7,burritos,Burritos,8,d,47,27,11,46,23.9,7,30,23.3,4,16,25.0,1,3,33.3,10,26,36,6,23,7,1,4,8,7,1,4,2,2,9
20191031-1930-greenmachine-burritos,burritos,Burritos,8,greenmachine,Green Machine,7,w,27,47,19,54,35.2,17,36,47.2,2,18,11.1,7,13,53.8,13,24,37,12,12,16,4,1,4,2,2,8,7,1,66
20191031-2015-lostangels-northlondonlions,lostangels,Lost Angels,5,northlondonlions,North L Lions,8,d,59,55,24,58,41.4,20,45,44.4,4,13,30.8,3,9,33.3,15,25,40,19,14,10,1,3,11,4,7,10,5,5,67
20191031-2015-lostangels-northlondonlions,northlondonlions,North L Lions,8,lostangels,Lost Angels,5,w,55,59,22,54,40.7,10,30,33.3,12,24,50.0,3,8,37.5,11,22,33,13,14,9,3,1,10,5,5,11,4,7,66
20191031-2100-lions-rockets,lions,Lions,6,rockets,Rockets,7,d,49,38,15,39,38.5,11,26,42.3,4,13,30.8,4,8,50.0,5,14,19,8,16,13,0,1,15,13,2,8,4,4,26
20191031-2100-lions-rockets,rockets,Rockets,7,lions,Lions,6,w,38,49,21,41,51.2,21,38,55.3,0,3,0,7,23,30.4,13,21,34,7,17,8,1,0,8,4,4,15,13,2,53
20191107-1845-lions-camdenhells,lions,Lions,6,camdenhells,Camden Hells,10,d,34,31,13,45,28.9,9,26,34.6,4,19,21.1,1,3,33.3,4,26,30,9,16,11,1,1,13,11,2,5,2,3,23
20191107-1845-lions-camdenhells,camdenhells,Camden Hells,10,lions,Lions,6,w,31,34,13,51,25.5,13,48,27.1,0,3,0,8,20,40.0,16,30,46,11,15,9,1,1,5,2,3,13,11,2,43
20191107-1930-hotshots-greenmachine,hotshots,Hot Shots,7,greenmachine,Green Machine,8,w,34,35,15,44,34.1,15,38,39.5,0,6,0,5,6,83.3,12,27,39,8,21,7,6,1,14,9,5,6,3,3,35
20191107-1930-hotshots-greenmachine,greenmachine,Green Machine,8,hotshots,Hot Shots,7,d,35,34,13,47,27.7,12,39,30.8,1,8,12.5,7,20,35.0,13,18,31,13,14,13,1,6,6,3,3,14,9,5,33
20191107-2015-northlondonlions-rockets,northlondonlions,North L Lions,7,rockets,Rockets,7,d,39,33,12,45,26.7,11,34,32.4,1,11,9.1,8,23,34.8,20,26,46,5,15,7,4,2,19,9,10,19,9,10,30
20191107-2015-northlondonlions-rockets,rockets,Rockets,7,northlondonlions,North L Lions,7,w,33,39,14,42,33.3,13,36,36.1,1,6,16.7,10,21,47.6,11,20,31,6,11,11,2,4,19,9,10,19,9,10,35
20191107-2100-lostangels-burritos,lostangels,Lost Angels,7,burritos,Burritos,7,d,40,36,15,44,34.1,10,31,32.3,5,13,38.5,1,2,50.0,10,31,41,10,27,7,3,1,15,7,8,4,1,3,28
20191107-2100-lostangels-burritos,burritos,Burritos,7,lostangels,Lost Angels,7,w,36,40,13,52,25.0,11,36,30.6,2,16,12.5,12,16,75.0,9,20,29,4,11,21,1,3,4,1,3,14,7,7,48
20191114-1845-lostangels-greenmachine,lostangels,Lost Angels,6,greenmachine,Green Machine,8,w,17,60,27,57,47.4,24,49,49.0,3,8,37.5,3,4,75.0,9,33,42,21,14,17,9,1,3,1,2,2,2,0,102
20191114-1845-lostangels-greenmachine,greenmachine,Green Machine,8,lostangels,Lost Angels,6,d,60,17,8,52,15.4,7,42,16.7,1,10,10.0,0,2,0,12,22,34,5,24,13,1,9,2,2,0,3,1,2,-8
20191114-1930-hotshots-lions,hotshots,Hot Shots,7,lions,Lions,6,w,28,61,27,55,49.1,26,51,51.0,1,4,25.0,6,18,33.3,14,45,59,14,15,5,6,0,5,5,0,16,9,7,101
20191114-1930-hotshots-lions,lions,Lions,6,hotshots,Hot Shots,7,d,61,28,13,62,21.0,12,54,22.2,1,8,12.5,1,10,10.0,9,20,29,7,7,7,0,6,16,9,7,5,5,0,-11
20191114-2015-northlondonlions-camdenhells,northlondonlions,North L Lions,6,camdenhells,Camden Hells,9,d,46,32,12,50,24.0,12,38,31.6,0,12,0,8,14,57.1,13,20,33,3,10,6,5,2,7,5,2,13,8,5,29
20191114-2015-northlondonlions-camdenhells,camdenhells,Camden Hells,9,northlondonlions,North L Lions,6,w,32,46,20,54,37.0,20,49,40.8,0,5,0,6,10,60.0,16,28,44,12,11,4,2,5,13,8,5,7,5,2,48
20191114-2100-rockets-burritos,rockets,Rockets,7,burritos,Burritos,6,w,33,53,19,42,45.2,13,30,43.3,6,12,50.0,9,18,50.0,6,21,27,15,13,16,1,0,14,4,10,15,8,7,68
20191114-2100-rockets-burritos,burritos,Burritos,6,rockets,Rockets,7,d,53,33,14,39,35.9,12,31,38.7,2,8,25.0,3,7,42.9,7,21,28,8,22,10,0,1,15,8,7,14,4,10,26
20191017-1845-hotshots-rockets,rockets,Rockets,8,hotshots,Hot Shots,9,w,22,70,30,65,46.2,28,56,50.0,2,9,22.2,8,13,61.5,23,23,46,21,3,11,0,2,16,8,8,10,7,3,97
20191017-1845-hotshots-rockets,hotshots,Hot Shots,9,rockets,Rockets,8,d,70,22,6,31,19.4,4,25,16.0,2,6,33.3,8,15,53.3,5,15,20,4,18,3,2,0,10,7,3,16,8,8,7
